{
  "layer": "region_map:PIN_PLACE_2020",
  "property": "PIN_P_20",
  "values": [
    1203480,
    1204200,
    1204735,
    1205075,
    1205100,
    1205125,
    1205150,
    1212875,
    1218575,
    1219206,
    1221945,
    1227360,
    1228175,
    1228650,
    1233625,
    1233675,
    1236175,
    1239425,
    1239775,
    1242400,
    1249725,
    1251350,
    1254350,
    1256975,
    1259725,
    1259750,
    1260275,
    1262425,
    1262885,
    1263000,
    1264975,
    1267462,
    1267675,
    1271150,
    1271825,
    1272325,
    1276481
  ]
}
