{
  "layer": "region_map:SAR_PLACE_2020",
  "property": "SAR_P_20",
  "values": [
    1204925,
    1217273,
    1217300,
    1220825,
    1225000,
    1228045,
    1236200,
    1238690,
    1239067,
    1239600,
    1241150,
    1248875,
    1249675,
    1249787,
    1251342,
    1253425,
    1254238,
    1256525,
    1257450,
    1260475,
    1264175,
    1264325,
    1266000,
    1267425,
    1267450,
    1267887,
    1268100,
    1271580,
    1273725,
    1273900,
    1273950,
    1275175
  ]
}
