{
  "layer": "region_map:HIL_PLACE_2020",
  "property": "HIL_P_20",
  "values": [
    1201675,
    1203375,
    1206875,
    1208150,
    1210825,
    1211912,
    1212425,
    1218075,
    1219212,
    1220108,
    1222387,
    1225900,
    1236462,
    1238350,
    1241775,
    1242850,
    1249260,
    1254387,
    1255540,
    1257550,
    1259050,
    1260950,
    1262275,
    1264925,
    1269250,
    1271000,
    1271400,
    1271725,
    1272145,
    1273163,
    1273700,
    1276062,
    1278025
  ]
}
