{
  "layer": "region_map:MAN_PLACE_2020",
  "property": "MAN_P_20",
  "values": [
    1201475,
    1204350,
    1207950,
    1207975,
    1214700,
    1220375,
    1232150,
    1239067,
    1241150,
    1244175,
    1254250,
    1263225,
    1267258,
    1276050,
    1276740,
    1277467
  ]
}
